1111111111111
1000000000AC1
1000000000001
1P000000000E1
1111111111111