11111111111111111111
1C00A00001E000000AC1
10110110000011011001
10000000111000000001
10110100010001111001
10000111000100A00111
11110100000110000111
1111P001100000010C01
11111111111111111111