1111111111111111111111111111111111111111
1000A0000000000C00000C000000A000000000C1
101001010010000A101001000000010100000001
1010010010101010001001000000010100000001
1P0000000C00C0000000000000000000C0000001
100000000000000C000000000000000000000001
10000000A00000000000A0000000000000000001
1000000000000000000000000000000000000001
1000000000001110000000000000000000000001
10C0001001001C1000A000000000000000000001
10000000000010100000000000000A0000000001
10000000000010111A1000000000000000000001
1000000000101000001000000000000000000001
1000000000001110111000000000000000000001
1000000000000000000000000000000000000001
100000000AA00000000000000000A00000000001
1000A00000000001111110000000000000000001
1A000000000000010A001000000000000000A001
1000000000000001000010000000001111001111
1E0000A0000000C10E001C00000A0000000000C1
1111111111111111111111111111111111111111